rules = "Правила игры"
close = "Закрыть"
next = "Вперед"
prev = "Назад"
ok = "OK"
cancel = "Отмена"
fullscreen = "Полноэкранный режим"
niceCursor = "Симпатичный курсор"
options = "Настройки"
newGame = "Начать игру"
loadGame = "Загрузить игру"
topScores = "Доска почета"
about = "Об авторах"
exit = "Выход"
einsteinPuzzle = "Головоломка Эйнштейна"
version = "версия 2.0"
copyright = "Copyright (c) 2003-2005 Flowix Games"
anonymous = "Аноним"
enterName = "Введите ваше имя:"
empty = "-- Пусто --"
enterGame = "Название игры:"
saveError = "Ошибка сохранения игры"
saveGame = "Сохранить игру"
paused = "ИГРА ПРИОСТАНОВЛЕНА"
won = "ПОЗДРАВЛЯЮ!  ВЫ ВЫЙГРАЛИ!!!"
startNew = "Новая игра"
tryAgain = "Эта же"
loose = "ВЫ ПРОИГРАЛИ"
iddqd = "ЭТО ВАМ НЕ ДУМ КАКОЙ-НИБУДЬ!"
pause = "Пауза"
switch = "Скрытые"
save = "Сохранить"
help = "Справка"
loading = "Загружается....  Пожалуйста ждите...."
einsteinFlowix = "Головоломка Эйнштейна от Flowix Games"
enableSound = "Включить звуки"
expired = "Эта бета-версия устарела.  Скачайте новую с http://games.flowix.com"
volume = "Громкость:"
